2009 JUSTICE EXPENDITURE AND EMPLOYMENT EXTRACTS PROGRAM - NCJ 247018
This zip archive contains tables in individual .csv spreadsheets 	
from the 2009 Justice Expenditure and Employment Extracts (CJEE 	
Extracts) and .txt files providing supporting documentation. 	


Text files:	

CJEEHIST.TXT - 	an overview of the BJS Justice Expenditure and Employment series since 1971.
CJEEMETH.TXT - 	a description of how the data were collected, reviewed and adjusted.  It presents data limitations and how the data may differ from other sources.
CJEEDEF.TXT  - 	definitions of terms and concepts used in the spreadsheets,  including definitions of types of governments, population used, and governmental expenditure, employment, and functions.
CJEECOMP.TXT - 	important comparability issues between the CJEE Extracts data and data from the CJEE Surveys that the CJEE Extracts program replaced.


Spreadsheets:	

National estimates, by type of government and type of justice activity	

cjee0701.csv	Table 1. Percent distribution of expenditure for the justice system by type of government, fiscal year 2009 (final)
cjee0702.csv 	Table 2. Percent distribution of employment and payrolls for the justice system by level of government, March 2009 (final)
cjee0703.csv    Table 3. Percent distribution of expenditure for the justice system by type of government, fiscal year 2009 (final)
cjee0704.csv 	Table 4. Justice system expenditure by activity, character, and object, State and level of government, fiscal year 2009 (final)
cjee0705.csv 	Table 5. Justice system employment and percent distribution of full-time equivalent employment, by State and type of government, March 2009 (final)
cjee0706.csv 	Table 6. Percent distribution of justice system payrolls by State and type of government, March 2009 (final)
cjee0707.csv 	Table 7. Police protection sworn and nonsworn employment and payrolls and percent distribution of full-time equivalent employment by state and level of government, March 2009 (final)
cjee0708.csv    Table 8. Per capita justice expenditure (fiscal year 2009) and full-time equivalent justice employment per 10,000 population (July 2009) of state and local governments by activity and state (final)

Individual government functional detail for the State governments, 68 large counties, and 49 large cities	

cjee0709.csv 	Table 9.  Justice system expenditure of state governments by activity, character, and object, fiscal year 2009 (final)
cjee0710.csv 	Table 10. Detail of direct expenditure for correctional activities of state governments by character and object, fiscal year 2009 (final) 
cjee0711.csv 	Table 11. Justice system employment and payrolls of state governments by activity, March 2009 (final)
cjee0712.csv 	Table 12. Justice system expenditures of 68 large county governments by activity, character, and object, fiscal year 2009 (final)
cjee0713.csv 	Table 13. Justice system employment and payrolls of 68 large county governments by activity, March 2009 (final)
cjee0714.csv 	Table 14. Police protection sworn and nonsworn employment and payrolls and percent distribution of full-time equivalent employment of 68 large county governments, March 2009 (final)
cjee0715.csv 	Table 15. Justice system expenditure of 49 large city governments by activity, character, and object, fiscal year 2009 (final)
cjee0716.csv 	Table 16. Justice system employment and payrolls of 49 large city governments by activity, March 2009 (final)
cjee0717.csv 	Table 17. Police protection sworn and nonsworn employment and payrolls and percent distribution of full-time equivalent employment of 49 large city governments, March 2009 (final)

Supplemental tables presenting data such as population, personal income, and expenditure and employment data for all government functions for states, 68 large counties, and 49 large cities	

cjee0718.csv 	Table 18. Supplemental data for state governments (final)
cjee0719.csv 	Table 19. Supplemental data for 68 large county governments (final)
cjee0720.csv 	Table 20. Supplemental data for 49 large city governments (final)
